NO          textures/text1.xpm
SO ./textures/text2.xpm
EA     ./textures/text3.xpm
WE   ./textures/text4.xpm         


F  255,142,35  
C     245,   26,3
11111111111111111111                       
11111111111111110111111111
100000110000011000001
100001100000110000001
100001100000110000001
100000110000011000001
100000000000000000001
100000000000000000001
100000000110000000001
100000001001000000001
100000000110000000001
100000000000000000001
111110101111101011101
100000101000101000001
101111101011101111111
101000001010100000101
101011111010111110101
101010001010100010101
101110101010101010101
100000101010001010001
111111101011111011101
100000101000100010001
101110101110101110111
101000100000100010101
101011111111111010101
100010000000000010001
101010111011111111101
1N1000001000000000001
111111111111111111111
111111111111111111111
     11      11
     11      11
     11      11
   1111    1111  
