NO      ./textures/eagle.xpm
SO      ./textures/greystone.xpm

EA      ./textures/red.xpm
WE      ./textures/purplestone.xpm
F       220,100,69

C       225,30,16




111111
100101
101001
1100N1
111111